%%%%%%%%%%%%%%%%%%%%
%P....   %   ..    %
% %%%%% %%% %% %%%%%
% %   % %   % %  O %
% % % % % %%% % %%%%
% % % % %   % %    %
% %%%% %%%% % %%%  %
%    .     %    G  %
%%% %%%%%% %   %%%%%
%   %   %    %   . %
% %%% % %%%%% %%%%%%
%   % %     %      %
% % % % %%% % %%%  %
% % % % % % %   %  %
% % % % % % % %%%  %
% %   % % % % %    %
% %%%%% % % % % %% %
%     %   % % %    %
% %%%%%%%% %%%% %  %
%.....  O    E  .  %
%%%%%%%%%%%%%%%%%%%%
