%%%%%%%%%%%%%%%%%%%%
%P....       ..  E%%
% %%%%% %%% %% %%%%%
% %   % %   % %  O%%
% % % % % %%% % %%%%
% % % % %   % %   %%
% %%%% %%%% % %%% %%
%    .     % %  G %%
%%% %%%%%% % % %%%%%
%   %   %        .%%
% %%% % %%%%% %%%%%%
%   % %     %     %%
% % % % %%% % %%% %%
% % % % % % %   % %%
% % % % % % % %%% %%
% %   % % % % %   %%
% %%%%% % % % % %%%%
%     %   % % %   %%
% %%%%%%%% %%%% % %%
%.....  O       . %%
%%%%%%%%%%%%%%%%%%%%
