%%%%%%%%%%
%P..  . E%
% %% %%% %
%    %   %
%% %%% %%%
%  G  O  %
%%%%%%%%%%
